__map__
3737373737373737373737373737373737373737373737373737373737373737373737373737373737373737373737373737373737373737373737373737373700000000000000000000000000000000000000000000000000000000000000000000000000000000000000000000000000000000000000000000000000000000
3700000000000000000000000000000000000000000000000000000000000000000000000000000000000000000000000000000000000000000000000000003700000000000000000000000000000000000000000000000000000000000000000000000000000000000000000000000000000000000000000000000000000000
373a3e00000000003e0000000000003e0000000000000000003e0000000000000000000000000000000000000000000000000000000000000000000000003e3700000000000000000000000000000000000000000000000000000000000000000000000000000000000000000000000000000000000000000000000000000000
37303032000000003e0000000000313030320000000000390000003a00000000000000003e00003e00003e00000000000000003e00000000000000000000003700000000000000000000000000000000000000000000000000000000000000000000000000000000000000000000000000000000000000000000000000000000
373300000000000000000000000000330000000000313030303030303200000000000000000000000000000000000000003900003a3800000000000000393e3700000000000000000000000000000000000000000000000000000000000000000000000000000000000000000000000000000000000000000000000000000000
3700000000003a0039000000000000000000000000000033000033000000000000390039383a3900393a3839000000313030303030303200000000313030303700000000000000000000000000000000000000000000000000000000000000000000000000000000000000000000000000000000000000000000000000000000
3700000000313030303030320000003a3900000000003a000000000000000031303030303030303030303030303032000000330033330000000000003300333700000000000000000000000000000000000000000000000000000000000000000000000000000000000000000000000000000000000000000000000000000000
3700003a0000003300003300003130303030320000313030320000000000000033000000330000003333000033000000000000393a003e00390000000000003700000000000000000000000000000000000000000000000000000000000000000000000000000000000000000000000000000000000000000000000000000000
3731303030320000000000000000330033000000000000330000000000000000000000000000000000003e00000000003130303030303030303200000000003700000000000000000000000000000000000000000000000000000000000000000000000000000000000000000000000000000000000000000000000000000000
37000033000000000000003e003a003900000000000000000000003e00003e00003e00000000000000000000000000000000330000330033000000000000003700000000000000000000000000000000000000000000000000000000000000000000000000000000000000000000000000000000000000000000000000000000
3700000000000000313030303030303030320000000000003a3900003a0000003a0039000000000000393a00000000000000000000000000000000000000003700000000000000000000000000000000000000000000000000000000000000000000000000000000000000000000000000000000000000000000000000000000
373e00000000000000003300003300333300003e003130303030303030303030303030303200003130303030303200000000000000000000000000000000003700000000000000000000000000000000000000000000000000000000000000000000000000000000000000000000000000000000000000000000000000000000
370000000000000000000000000000000000000000000033000033000033330033003300000000000000330000003e0000000000000000000000003a39003e3700000000000000000000000000000000000000000000000000000000000000000000000000000000000000000000000000000000000000000000000000000000
373e00000000000000003a0000000000003900000000000000000000000000000000000000000000000000000000000000003a3e39000000000031303030303700000000000000000000000000000000000000000000000000000000000000000000000000000000000000000000000000000000000000000000000000000000
3730303200000000313030303200313030303032000000000000000000000000000000000000000000000000000000003130303030320000000000330000333700000000000000000000000000000000000000000000000000000000000000000000000000000000000000000000000000000000000000000000000000000000
37003300003e00000000003300000033000033000000003e00003e00000000003e00003e0000000000000000000000000000330000000000000000000000003700000000000000000000000000000000000000000000000000000000000000000000000000000000000000000000000000000000000000000000000000000000
3700000000000000000000393e3e3e00000000000000000000000000000000000039000000000000000000003900003a000039000000000000003a000000003700000000000000000000000000000000000000000000000000000000000000000000000000000000000000000000000000000000000000000000000000000000
37000000000000000031303030303030320000390000390000003a3900003130303030303032003e00313030303030303030303030320000313030320000003700000000000000000000000000000000000000000000000000000000000000000000000000000000000000000000000000000000000000000000000000000000
37000000393a0000003a00330033330000003130303030303030303030303200333300003300003900003300330033330000330033000000003300000000003700000000000000000000000000000000000000000000000000000000000000000000000000000000000000000000000000000000000000000000000000000000
3700313030303030303032000000000000000000330000330000333300000000000000000031303030320000000000000000000000000000000000000000003700000000000000000000000000000000000000000000000000000000000000000000000000000000000000000000000000000000000000000000000000000000
3700003300333300330000000000000000000000000000000000000000000000003e003e000000330000000000003e00000000000000000000000039003e003700000000000000000000000000000000000000000000000000000000000000000000000000000000000000000000000000000000000000000000000000000000
370000000000000000003e00000000000000000000000000000000000000000000000000000000000000000000000000003a003900000000000031303030303700000000000000000000000000000000000000000000000000000000000000000000000000000000000000000000000000000000000000000000000000000000
373a3e000000000039003a000000000000003e393e3a000000000000003a3900000000000000000000000000390000003130303030320000000000330000333700000000000000000000000000000000000000000000000000000000000000000000000000000000000000000000000000000000000000000000000000000000
373030303200313030303030320000003130303030303200000000313030303032000000000000000000313030303200000000330000000000000000003e003700000000000000000000000000000000000000000000000000000000000000000000000000000000000000000000000000000000000000000000000000000000
373300330000000033330000000000000033000033000000000000000033330000000000003e3e3e39000033003300000000000000393a00000000000000003700000000000000000000000000000000000000000000000000000000000000000000000000000000000000000000000000000000000000000000000000000000
3700000000000000000000000000000000000000000000000000000000000000000000313030303030320000000000000000003130303030303200000000003700000000000000000000000000000000000000000000000000000000000000000000000000000000000000000000000000000000000000000000000000000000
37000000000000000000000000000000000000000000003e3e3e3e0000000000000000000000330000000000000000000000003900330033330000000000393700000000000000000000000000000000000000000000000000000000000000000000000000000000000000000000000000000000000000000000000000000000
370000003e00000000000000000000000000000000003a390000390000000000000000000000000000000000000000313030303032000000000031303030303700000000000000000000000000000000000000000000000000000000000000000000000000000000000000000000000000000000000000000000000000000000
370031303030320000000000000000000000000031303030303030303032390000000000000000000000000000000000330033000000003e000000000033333700000000000000000000000000000000000000000000000000000000000000000000000000000000000000000000000000000000000000000000000000000000
370000003300000039003a3839000000000000003a3737373737373737303030323a3900383a3900003900003a003900000000003a00003900000039003a383700000000000000000000000000000000000000000000000000000000000000000000000000000000000000000000000000000000000000000000000000000000
3730303030303030303030303030303030303030303737373737373737373737303030303030303030303030303030303030303030303030303030303030303700000000000000000000000000000000000000000000000000000000000000000000000000000000000000000000000000000000000000000000000000000000
3737373737373737373737373737373737373737373737373737373737373737373737373737373737373737373737373737373737373737373737373737373700000000000000000000000000000000000000000000000000000000000000000000000000000000000000000000000000000000000000000000000000000000
